1111111111111111111111111111111
100000000000000C0001C1000000001
11111000111000111001E1110000001
1000100000100000100000010000111
10001000111C0011100C011100000C1
1000100000100000100000010001111
10011100111000111C0000010000001
10000000000P0000000000000000011
1111111111111111111111111111111