111111111111111111111111111111
100111110011000100000100001111
110000000001110100100001100011
110111011000010000001101001011
110000000000000010111001100001
101011011111000010000010111111
100000000000001101110000010001
1110011111110CE000111110111001
10001100000000C100000000000001
110100010111110001011110100101
110101110101000000000000110101
110100001111011110001100100111
1010001101C1010N11P01000111101
100010000100111000000011010111
100011011100000000100000000001
111111111111111111111111111111